6 10
- - - - O O O O - - 
- O O O - M - O - - 
- - - O - - - O - M 
- - O O O O - O O O 
- O - O O - M O O - 
- - - - - - - - - - 
