10 5
- O M O - 
O - - - - 
M O O - O 
O - - - O 
O O - O O 
- O O - O 
O - O O - 
- - - - - 
O - - - O 
- - O - O 
