6 9
- - O - O - - - - 
- - - - O - - - - 
- - - - - - M - O 
- - - O - - - - - 
- O - - O O - - - 
- - - - - O - M - 
