8 7
- O O - - - - 
- O - - O O - 
- O - - O - O 
- O O - O - M 
O - O - O - - 
O - - - - - - 
O O - - - O - 
- O O - - - - 
